Image name,Top,Bottom,Left,Right,width,height
IMG_1.jpg,237,237,194,194,388,474
IMG_2.jpg,39,39,0,63,63,78
IMG_3.jpg,839,76,0,0,0,915
IMG_4.jpg,54,2165,0,0,0,2219
IMG_5.jpg,6,1271,0,0,0,1277
IMG_6.jpg,32,3248,0,0,0,3280
IMG_7.jpg,256,157,0,0,0,413
IMG_8.jpg,65,64,48,49,97,129
IMG_9.jpg,237,214,0,0,0,451
IMG_10.jpg,49,49,36,37,73,98
